1111111111111
1001000000BC1
1000011110001
1P0011E000BT1
1111111111111