11111111111111111111111
10010001000100PEC100101
11111111111111111111111