11111111111111111111111
10010P00C00000000000001
10000111111111100000001
1000110000000000E000001
10010000000000001000101
10010000000000000000001
10000000000000000000BT1
10000000000000000000001
10000000000000000000001
11111111111111111111111