11111111111111111111111
10010000000000000000001
10000111111111000000001
100011E0000000000000001
10010000000000000000001
10010000000000000000001
10010000000000000000001
10010000000000000000001
10010000000000000000001
10010000000000000000001
10010000000000000000001
10010000000000000000001
1001000000000000C000001
10010000000000001000001
10010000000000000000001
10010000000000000000001
10010000000000000000001
10P10000000000000000001
11111111111111111111111