11111111111111111111111
10010P00000000000CCCC01
10000111111111C00000001
1000110000000000E000001
10010000000000001000101
10010000000000000000001
100000000000000C0000BT1
100000000000000C0000001
1000000C0000000000C0001
11111111111111111111111