11111111111111111111111
100100000000000000000C1
10000111111111000000001
1P0011E0C00000000000001
100100000000000000000C1
100100000000000000000C1
100100000000000000000C1
100100000000000000000C1
100100000000000000000C1
100100000000000000000C1
100100000000000000000C1
100100000000000000000C1
100100000000000000000C1
100100000000000010000C1
100100000000000000000C1
100100000000000000000C1
100100000000000000000C1
100100000000000000000C1
11111111111111111111111