1111111111111
10011000000C1
1000011110001
1P0011E000BT1
1111111111111