111111111111111111111111111111
100000000000011111111111111111
100000000000011111111111111111
100000000000011111111111111111
10000P000000011111111111111111
10000E000000011111111111111111
10000C000000011111111111111111
100000000000011111111111111111
100000000000011111111111111111
100000000000011111111111111111
100000000000011111111111111111
100000000000011111111111111111
100000000000011111111111111111
100000000000011111111111111111
100000000000011111111111111111
100000000000011111111111111111
100000000000011111111111111111
111111111111111111111111111111