11111111111111111
10000000000000001
10000P00000000001
10001C00000000001
10001C00000000001
10001000000000001
10001111111110001
1CC01E00000000BT1
11111111111111111