11111111111111111111111
10010000000000000000001
10000111111111000000001
10001100000000000000001
10010000000000001000001
10010000000000000000001
100000000000000C0000001
10000000000000000000001
1000000000000P00000E001
11111111111111111111111