11111111111111111111111
10010P00000000000000001
10000111111111000000001
1000110000000000E000001
10010000000000001000001
10010000000000000000001
100000000000000C0000001
10000000000000000000001
10000000000000000000BT1
11111111111111111111111